{
  "name": "level_47",

  "time": 105,
  "gems": [ 70, 30 ],
  "layout":
  [

    [3, 3, 3, 0, 0, 6, 0, 3, 3, 3],
    [3, 3, 0, 0, 0, 0, 6, 0, 3, 3],
    [3, 0, 0, 6, 0, 0, 0, 0, 0, 3],
    [4, 0, 0, 0, 0, 0, 0, 0, 0, 4],
    [4, 0, 6, 0, 6, 0, 6, 0, 0, 4],
    [4, 0, 6, 0, 0, 0, 0, 0, 0, 4],
    [4, 0, 6, 0, 0, 0, 0, 0, 0, 4],
    [4, 0, 6, 0, 0, 0, 0, 0, 0, 4],
    [4, 0, 0, 0, 0, 0, 0, 0, 0, 4],
    [4, 0, 0, 0, 6, 0, 6, 0, 0, 4],
    [6, 0, 0, 0, 0, 0, 0, 0, 0, 6],
    [3, 0, 0, 0, 0, 0, 0, 0, 0, 3],
    [3, 3, 0, 0, 0, 0, 6, 0, 3, 3],
    [3, 3, 3, 0, 0, 0, 0, 3, 3, 3]
  ],

  "gold_level": false,

  "runes_weight":
  [
    {"rune": "fire", "weight": 20},
    {"rune": "lightning", "weight": 20},
    {"rune": "plant", "weight": 20},
    {"rune": "water", "weight": 20},
	{"rune": "earth", "weight": 0},
	{"rune": "psy", "weight": 10}
  ],

  "medallions":
  [
    {"score":  5000, "exp": 35000},
    {"score":  7000, "exp": 50000},
    {"score":  9000, "exp": 100000}
  ]
}