{
  "name": "level_38",

  "time":90,
  "gems": [ 60, 30 ],
  "layout":
  [

    [3, 3, 3, 3, 3, 3, 3, 3, 3, 3],
    [3, 3, 3, 3, 3, 3, 3, 3, 3, 3],
    [3, 6, 6, 6, 6, 6, 6, 6, 6, 3],
    [6, 0, 0, 0, 0, 0, 0, 0, 0, 6],
    [6, 0, 0, 0, 0, 0, 0, 0, 0, 6],
    [6, 0, 0, 0, 0, 0, 0, 0, 0, 6],
    [6, 0, 0, 0, 0, 0, 0, 0, 0, 6],
    [6, 0, 0, 0, 0, 0, 0, 0, 0, 6],
    [6, 0, 0, 0, 0, 0, 0, 0, 0, 6],
    [6, 0, 0, 0, 0, 0, 0, 0, 0, 6],
    [6, 0, 0, 0, 0, 0, 0, 0, 0, 6],
    [3, 6, 6, 6, 6, 6, 6, 6, 6, 3],
    [3, 3, 3, 3, 3, 3, 3, 3, 3, 3],
    [3, 3, 3, 3, 3, 3, 3, 3, 3, 3]
  ],

  "gold_level": false,

  "runes_weight":
  [
    {"rune": "fire", "weight": 20},
    {"rune": "lightning", "weight": 20},
    {"rune": "plant", "weight": 20},
    {"rune": "water", "weight": 20},
	{"rune": "earth", "weight": 0},
	{"rune": "psy", "weight": 10}
  ],

  "medallions":
  [
    {"score": 8000, "exp": 30000},
    {"score": 10000, "exp": 35000},
    {"score": 12000, "exp": 50000}
  ]
}