{
  "name": "level_30",

  "time": 75,
  "gems": [ 50, 30 ],
  "layout":
  [

    [3, 3, 3, 3, 3, 3, 3, 3, 3, 3],
    [3, 3, 0, 0, 0, 0, 0, 0, 3, 3],
    [3, 0, 0, 0, 0, 0, 0, 0, 0, 3],
    [0, 0, 0, 0, 0, 0, 0, 0, 0, 0],
    [1, 1, 1, 0, 0, 0, 0, 1, 1, 1],
    [1, 1, 1, 0, 0, 0, 0, 1, 1, 1],
    [1, 1, 1, 0, 0, 0, 0, 1, 1, 1],
    [1, 1, 1, 5, 3, 3, 5, 1, 1, 1],
    [1, 1, 1, 5, 0, 0, 5, 1, 1, 1],
    [1, 1, 1, 5, 0, 0, 5, 1, 1, 1],
    [0, 0, 0, 5, 0, 0, 5, 0, 0, 0],
    [3, 0, 0, 0, 0, 0, 0, 0, 0, 3],
    [3, 3, 0, 0, 0, 0, 0, 0, 3, 3],
    [3, 3, 3, 0, 0, 0, 0, 3, 3, 3]
  ],

  "gold_level": true,

  "runes_weight":
  [
    {"rune": "fire", "weight": 40},
    {"rune": "lightning", "weight": 20},
    {"rune": "plant", "weight": 20},
    {"rune": "water", "weight": 20},
	{"rune": "earth", "weight": 10},
	{"rune": "psy", "weight": 0}
  ],

  "medallions":
  [
    {"score": 8000, "exp": 15000},
    {"score": 10000, "exp": 20000},
    {"score": 11500, "exp": 25000}
  ]
}