{
  "name": "level_11",

  "time": 90,
  "gems": [ 60, 30 ],
  "layout":
  [

    [3, 3, 3, 0, 4, 0, 0, 3, 3, 3],
    [3, 3, 0, 0, 0, 0, 0, 0, 3, 3],
    [3, 0, 4, 0, 4, 4, 0, 0, 0, 3],
    [0, 0, 4, 0, 0, 0, 0, 0, 0, 0],
    [0, 0, 0, 0, 4, 0, 0, 4, 0, 4],
    [4, 0, 0, 0, 0, 0, 0, 0, 0, 0],
    [4, 0, 0, 0, 0, 0, 4, 0, 0, 0],
    [0, 0, 4, 4, 4, 0, 0, 0, 0, 0],
    [0, 0, 0, 0, 0, 0, 0, 0, 0, 4],
    [0, 0, 4, 0, 0, 0, 0, 0, 0, 0],
    [0, 0, 0, 0, 4, 0, 4, 4, 0, 0],
    [3, 0, 0, 0, 4, 0, 0, 0, 0, 3],
    [3, 3, 0, 0, 0, 0, 0, 0, 3, 3],
    [3, 3, 3, 0, 0, 0, 0, 3, 3, 3]
  ],

  "gold_level": false,

  "runes_weight":
  [
    {"rune": "fire", "weight": 20},
    {"rune": "lightning", "weight": 0},
    {"rune": "plant", "weight": 20},
    {"rune": "water", "weight": 0},
	{"rune": "earth", "weight": 0},
	{"rune": "psy", "weight": 10}
  ],

  "medallions":
  [
    {"score": 20000, "exp": 30000},
    {"score": 27000, "exp": 35000},
    {"score": 31000, "exp": 50000}
  ]
}