{
  "name": "level_26",

  "time": 75,
  "gems": [ 50, 30 ],
  "layout":
  [

    [3, 3, 3, 0, 0, 0, 0, 3, 3, 3],
    [3, 3, 0, 0, 0, 0, 0, 0, 3, 3],
    [3, 3, 0, 0, 0, 0, 0, 0, 3, 3],
    [0, 0, 3, 0, 0, 0, 0, 3, 0, 0],
    [0, 0, 0, 3, 0, 0, 3, 0, 0, 0],
    [0, 0, 0, 0, 3, 3, 0, 0, 0, 0],
    [0, 0, 0, 0, 3, 3, 0, 0, 0, 0],
    [0, 0, 0, 0, 3, 3, 0, 0, 0, 0],
    [0, 0, 0, 0, 3, 3, 0, 0, 0, 0],
    [0, 0, 0, 0, 3, 3, 0, 0, 0, 0],
    [0, 0, 0, 0, 3, 3, 0, 0, 0, 0],
    [3, 0, 0, 0, 3, 3, 0, 0, 0, 3],
    [3, 3, 0, 0, 3, 3, 0, 0, 3, 3],
    [3, 3, 3, 0, 3, 3, 0, 3, 3, 3]
  ],

  "gold_level": false,

  "runes_weight":
  [
    {"rune": "fire", "weight": 20},
    {"rune": "lightning", "weight": 40},
    {"rune": "plant", "weight": 20},
    {"rune": "water", "weight": 20},
	{"rune": "earth", "weight": 10},
	{"rune": "psy", "weight": 0}
  ],

  "medallions":
  [
    {"score": 7000, "exp": 15000},
    {"score": 10000, "exp": 20000},
    {"score": 11000, "exp": 25000}
  ]
}