{
  "name": "level_43",

  "time": 105,
  "gems": [ 70, 30 ],
  "layout":
  [

    [3, 3, 3, 0, 0, 0, 0, 3, 3, 3],
    [3, 3, 0, 0, 2, 2, 0, 0, 3, 3],
    [3, 0, 0, 0, 2, 2, 0, 0, 0, 3],
    [0, 0, 2, 0, 1, 1, 0, 2, 0, 0],
    [0, 1, 1, 1, 1, 1, 1, 1, 1, 0],
    [0, 1, 2, 2, 2, 2, 2, 2, 1, 0],
    [0, 0, 1, 2, 2, 2, 2, 1, 0, 0],
    [0, 0, 1, 1, 2, 2, 1, 1, 0, 0],
    [0, 0, 1, 1, 2, 2, 1, 1, 0, 0],
    [0, 0, 0, 1, 2, 2, 1, 0, 0, 0],
    [0, 0, 0, 1, 1, 1, 1, 0, 0, 0],
    [3, 0, 0, 0, 1, 1, 0, 0, 0, 3],
    [3, 3, 0, 0, 0, 0, 0, 0, 3, 3],
    [3, 3, 3, 0, 0, 0, 0, 3, 3, 3]
  ],

  "gold_level": true,

  "runes_weight":
  [
    {"rune": "fire", "weight": 20},
    {"rune": "lightning", "weight": 20},
    {"rune": "plant", "weight": 0},
    {"rune": "water", "weight": 20},
	{"rune": "earth", "weight": 10},
	{"rune": "psy", "weight": 0}
  ],

  "medallions":
  [
    {"score": 18000, "exp": 30000},
    {"score": 22000, "exp": 35000},
    {"score": 26000, "exp": 50000}
  ]
}