{
  "name": "level_46",

  "time": 105,
  "gems": [ 70, 30 ],
  "layout":
  [

    [3, 3, 3, 0, 0, 3, 0, 3, 3, 3],
    [3, 3, 0, 0, 0, 3, 0, 0, 3, 3],
    [3, 0, 0, 0, 0, 0, 3, 0, 0, 3],
    [0, 0, 0, 0, 0, 0, 3, 3, 0, 0],
    [0, 0, 0, 0, 0, 0, 0, 3, 3, 3],
    [0, 0, 0, 0, 0, 0, 0, 0, 0, 0],
    [3, 3, 3, 3, 3, 0, 0, 0, 0, 0],
    [0, 0, 0, 0, 3, 0, 0, 0, 0, 0],
    [0, 0, 0, 0, 3, 0, 0, 0, 0, 0],
    [0, 0, 0, 0, 3, 0, 0, 0, 0, 0],
    [0, 0, 0, 0, 3, 0, 0, 0, 0, 0],
    [3, 0, 0, 0, 3, 0, 0, 0, 0, 3],
    [3, 3, 0, 0, 3, 0, 0, 0, 3, 3],
    [3, 3, 3, 0, 3, 0, 0, 3, 3, 3]
  ],

  "gold_level": false,

  "runes_weight":
  [
    {"rune": "fire", "weight": 0},
    {"rune": "lightning", "weight": 20},
    {"rune": "plant", "weight": 20},
    {"rune": "water", "weight": 20},
	{"rune": "earth", "weight": 0},
	{"rune": "psy", "weight": 0}
  ],

  "medallions":
  [
    {"score":  20000, "exp": 35000},
    {"score":  25000, "exp": 50000},
    {"score":  28000, "exp": 100000}
  ]
}