{
  "name": "level_41",

  "time": 105,
  "gems": [ 70, 30 ],
  "layout":
  [

    [3, 3, 3, 0, 4, 4, 0, 3, 3, 3],
    [3, 3, 0, 0, 4, 4, 0, 0, 3, 3],
    [3, 0, 0, 0, 4, 4, 0, 0, 0, 3],
    [0, 2, 2, 1, 0, 0, 1, 2, 2, 0],
    [0, 2, 2, 1, 0, 0, 1, 2, 2, 0],
    [0, 2, 2, 0, 0, 0, 0, 2, 2, 0],
    [0, 2, 2, 0, 0, 0, 0, 2, 2, 0],
    [0, 2, 2, 0, 0, 0, 0, 2, 2, 0],
    [0, 2, 2, 3, 0, 0, 3, 2, 2, 0],
    [0, 2, 2, 3, 0, 0, 3, 2, 2, 0],
    [0, 2, 2, 3, 0, 0, 3, 2, 2, 0],
    [3, 0, 0, 3, 0, 0, 3, 0, 0, 3],
    [3, 3, 0, 3, 0, 0, 3, 0, 3, 3],
    [3, 3, 3, 3, 0, 0, 3, 3, 3, 3]
  ],

  "gold_level": true,

  "runes_weight":
  [
    {"rune": "fire", "weight": 20},
    {"rune": "lightning", "weight": 0},
    {"rune": "plant", "weight": 0},
    {"rune": "water", "weight": 20},
	{"rune": "earth", "weight": 10},
	{"rune": "psy", "weight": 10}
  ],

  "medallions":
  [
    {"score": 12000, "exp": 30000},
    {"score": 14000, "exp": 35000},
    {"score": 18000, "exp": 50000}
  ]
}