{
  "name": "level_10",

  "time": 60,
  "gems": [ 40, 20 ],
  "layout":
  [

    [3, 3, 3, 0, 0, 0, 0, 3, 3, 3],
    [3, 3, 0, 0, 0, 0, 0, 0, 3, 3],
    [3, 0, 0, 0, 3, 0, 0, 0, 0, 3],
    [0, 0, 0, 0, 0, 0, 0, 0, 3, 0],
    [0, 3, 0, 0, 0, 0, 0, 0, 0, 3],
    [0, 0, 0, 3, 0, 0, 0, 3, 0, 0],
    [0, 0, 0, 0, 0, 0, 0, 0, 0, 0],
    [0, 0, 0, 0, 0, 0, 3, 0, 0, 0],
    [3, 0, 0, 0, 0, 0, 0, 0, 0, 0],
    [0, 0, 0, 0, 0, 3, 0, 0, 0, 0],
    [0, 0, 3, 0, 0, 0, 0, 0, 0, 0],
    [3, 0, 0, 0, 3, 0, 0, 3, 0, 3],
    [3, 3, 0, 0, 0, 0, 0, 0, 3, 3],
    [3, 3, 3, 0, 0, 0, 0, 3, 3, 3]
  ],

  "gold_level": false,

  "runes_weight":
  [
    {"rune": "fire", "weight": 25},
    {"rune": "lightning", "weight": 25},
    {"rune": "plant", "weight": 25},
    {"rune": "water", "weight": 25},
	{"rune": "earth", "weight": 0},
	{"rune": "psy", "weight": 0}
  ],

  "medallions":
  [
	 {"score": 2000, "exp": 2000},
    {"score": 4000, "exp": 3000},
    {"score": 6000, "exp": 5000}
	
  ]
}