{
  "name": "level_21",

  "time": 75,
  "gems": [ 50, 30 ],
  "layout":
  [

    [3, 3, 3, 0, 0, 0, 0, 3, 3, 3],
    [3, 3, 0, 0, 0, 6, 0, 0, 3, 3],
    [3, 3, 0, 0, 0, 6, 0, 0, 3, 3],
    [0, 0, 0, 0, 0, 0, 0, 0, 0, 0],
    [0, 5, 5, 3, 0, 0, 0, 0, 0, 0],
    [0, 0, 0, 0, 0, 0, 0, 3, 0, 0],
    [6, 0, 0, 0, 6, 0, 0, 3, 0, 6],
    [6, 3, 0, 6, 6, 0, 0, 3, 0, 6],
    [0, 0, 0, 0, 0, 0, 0, 0, 0, 0],
    [0, 0, 0, 3, 0, 0, 0, 0, 0, 0],
    [0, 0, 0, 0, 0, 5, 0, 0, 0, 0],
    [3, 3, 0, 0, 0, 5, 0, 0, 3, 3],
    [3, 3, 0, 0, 0, 0, 0, 0, 3, 3],
    [3, 3, 3, 0, 0, 0, 0, 3, 3, 3]
  ],

  "gold_level": false,

  "runes_weight":
  [
    {"rune": "fire", "weight": 20},
    {"rune": "lightning", "weight": 20},
    {"rune": "plant", "weight": 20},
    {"rune": "water", "weight": 20},
	{"rune": "earth", "weight": 10},
	{"rune": "psy", "weight": 0}
  ],

  "medallions":
  [
    {"score": 4000, "exp": 10000},
    {"score": 6000, "exp": 15000},
    {"score": 8000, "exp": 20000}
  ]
}