{
  "name": "level_19",

  "time": 80,
  "gems": [ 40, 20 ],
  "layout":
  [

    [3, 3, 3, 0, 0, 0, 0, 3, 3, 3],
    [3, 3, 1, 0, 4, 4, 0, 1, 3, 3],
    [3, 1, 1, 0, 0, 0, 0, 1, 1, 3],
    [1, 1, 1, 0, 0, 0, 0, 1, 1, 1],
    [1, 1, 1, 0, 0, 0, 0, 1, 1, 1],
    [1, 1, 1, 0, 0, 0, 0, 1, 1, 1],
    [1, 1, 1, 3, 3, 3, 3, 1, 1, 1],
    [1, 1, 1, 0, 4, 4, 0, 1, 1, 1],
    [1, 1, 1, 0, 0, 0, 0, 1, 1, 1],
    [1, 1, 1, 0, 0, 0, 0, 1, 1, 1],
    [1, 1, 1, 0, 0, 0, 0, 1, 1, 1],
    [3, 1, 1, 0, 0, 0, 0, 1, 1, 3],
    [3, 3, 1, 0, 0, 0, 0, 1, 3, 3],
    [3, 3, 3, 0, 0, 0, 0, 3, 3, 3]
  ],

  "gold_level": true,

  "runes_weight":
  [
    {"rune": "fire", "weight": 25},
    {"rune": "lightning", "weight": 25},
    {"rune": "plant", "weight": 25},
    {"rune": "water", "weight": 25},
	{"rune": "earth", "weight": 0},
	{"rune": "psy", "weight": 0}
  ],

  "medallions":
  [
     {"score": 5000,"exp": 5000},
     {"score": 10000, "exp": 10000},
     {"score": 12000, "exp": 12000}
  ]
}