{
  "name": "level_60",

  "time": 120,
  "gems": [ 90, 60, 30 ],
  "layout":
  [

    [3, 3, 3, 2, 2, 1, 2, 3, 3, 3],
    [3, 3, 2, 2, 2, 1, 2, 2, 3, 3],
    [3, 2, 2, 2, 2, 1, 2, 2, 2, 3],
    [2, 2, 3, 2, 2, 1, 3, 2, 2, 2],
    [2, 2, 3, 2, 2, 1, 3, 2, 3, 2],
    [2, 2, 2, 2, 2, 1, 2, 2, 3, 2],
    [2, 2, 2, 2, 2, 1, 2, 2, 2, 2],
    [1, 1, 1, 1, 1, 1, 1, 1, 1, 1],
    [2, 2, 2, 2, 2, 1, 3, 2, 2, 2],
    [2, 3, 2, 3, 2, 1, 3, 2, 2, 2],
    [2, 3, 2, 3, 2, 1, 2, 3, 3, 2],
    [3, 2, 2, 2, 2, 1, 2, 2, 2, 3],
    [3, 3, 2, 2, 2, 1, 2, 2, 3, 3],
    [3, 3, 3, 2, 2, 1, 2, 3, 3, 3]
  ],

  "gold_level": true,

  "runes_weight":
  [
    {"rune": "fire", "weight": 25},
    {"rune": "lightning", "weight": 25},
    {"rune": "plant", "weight": 25},
    {"rune": "water", "weight": 25},
	{"rune": "earth", "weight": 5},
	{"rune": "psy", "weight": 5}
  ],

  "medallions":
  [
    {"score": 18000, "exp": 50000},
    {"score": 20000, "exp": 100000},
    {"score": 28000, "exp": 250000}
  ]
}