{
  "name": "level_44",

  "time": 105,
  "gems": [ 70, 30 ],
  "layout":
  [

    [3, 3, 3, 0, 0, 0, 0, 3, 3, 3],
    [3, 3, 2, 2, 2, 2, 2, 2, 3, 3],
    [3, 2, 2, 2, 2, 2, 2, 2, 2, 3],
    [1, 2, 2, 2, 2, 2, 2, 2, 2, 1],
    [3, 3, 3, 3, 3, 3, 3, 3, 3, 3],
    [0, 0, 0, 0, 0, 0, 0, 0, 0, 0],
    [0, 0, 0, 0, 0, 0, 0, 0, 0, 0],
    [3, 3, 3, 3, 3, 3, 3, 3, 3, 3],
    [0, 0, 0, 0, 0, 0, 0, 0, 0, 0],
    [0, 0, 0, 0, 0, 0, 0, 0, 0, 0],
    [0, 0, 0, 0, 0, 0, 0, 0, 0, 0],
    [3, 0, 0, 0, 0, 0, 0, 0, 0, 3],
    [3, 3, 0, 0, 0, 0, 0, 0, 3, 3],
    [3, 3, 3, 3, 3, 3, 3, 3, 3, 3]
  ],

  "gold_level": true,

  "runes_weight":
  [
    {"rune": "fire", "weight": 20},
    {"rune": "lightning", "weight": 0},
    {"rune": "plant", "weight": 20},
    {"rune": "water", "weight": 0},
	{"rune": "earth", "weight": 10},
	{"rune": "psy", "weight": 10}
  ],

  "medallions":
  [
    {"score":  10000, "exp": 30000},
    {"score":  13000, "exp": 35000},
    {"score":  16000, "exp": 50000}
  ]
}