{
  "name": "level_29",

  "time": 75,
  "gems": [ 50, 30 ],
  "layout":
  [

    [3, 3, 3, 0, 0, 0, 0, 3, 3, 3],
    [3, 3, 1, 0, 1, 1, 0, 1, 3, 3],
    [3, 0, 1, 0, 1, 1, 0, 1, 0, 3],
    [0, 0, 1, 0, 1, 1, 0, 1, 0, 0],
    [0, 0, 1, 0, 1, 1, 0, 1, 0, 0],
    [0, 0, 1, 0, 1, 1, 0, 1, 0, 0],
    [0, 0, 1, 0, 1, 1, 0, 1, 0, 0],
    [0, 0, 1, 0, 1, 1, 0, 1, 0, 0],
    [0, 0, 2, 2, 2, 2, 2, 2, 0, 0],
    [0, 0, 2, 2, 2, 2, 2, 2, 0, 0],
    [0, 0, 2, 2, 2, 2, 2, 2, 0, 0],
    [3, 0, 0, 0, 0, 0, 0, 0, 0, 3],
    [3, 3, 0, 0, 0, 0, 0, 0, 3, 3],
    [3, 3, 3, 3, 3, 3, 3, 3, 3, 3]
  ],

  "gold_level": true,

  "runes_weight":
  [
    {"rune": "fire", "weight": 20},
    {"rune": "lightning", "weight": 20},
    {"rune": "plant", "weight": 20},
    {"rune": "water", "weight": 20},
	{"rune": "earth", "weight": 10},
	{"rune": "psy", "weight": 0}
  ],

  "medallions":
  [
    {"score": 4000, "exp": 15000},
    {"score": 6000, "exp": 20000},
    {"score": 9000, "exp": 25000}
  ]
}