{
  "name": "level_59",

  "time": 120,
  "gems": [ 90, 60, 30 ],
  "layout":
  [

    [3, 3, 3, 0, 3, 3, 0, 3, 3, 3],
    [3, 3, 0, 0, 3, 3, 0, 0, 3, 3],
    [3, 0, 0, 0, 0, 0, 0, 0, 0, 3],
    [0, 0, 0, 0, 0, 0, 0, 0, 0, 0],
    [0, 0, 0, 0, 0, 0, 0, 0, 0, 0],
    [3, 3, 3, 0, 0, 0, 0, 3, 3, 3],
    [3, 3, 3, 0, 0, 0, 0, 3, 3, 3],
    [3, 3, 3, 0, 0, 0, 0, 3, 3, 3],
    [3, 3, 3, 0, 0, 0, 0, 3, 3, 3],
    [0, 0, 0, 0, 0, 0, 0, 0, 0, 0],
    [0, 0, 0, 0, 0, 0, 0, 0, 0, 0],
    [3, 0, 0, 0, 0, 0, 0, 0, 0, 3],
    [3, 3, 0, 0, 3, 3, 0, 0, 3, 3],
    [3, 3, 3, 0, 3, 3, 0, 3, 3, 3]
  ],

  "gold_level": false,

  "runes_weight":
  [
    {"rune": "fire", "weight": 25},
    {"rune": "lightning", "weight": 25},
    {"rune": "plant", "weight": 25},
    {"rune": "water", "weight": 25},
	{"rune": "earth", "weight": 5},
	{"rune": "psy", "weight": 5}
  ],

  "medallions":
  [
    {"score":  9000, "exp": 50000},
    {"score":  12000, "exp": 100000},
    {"score":  15000, "exp": 250000}
  ]
}