{
  "name": "level_5",

  "time": 60,
  "gems": [ 0 ],
  "layout":
  [

    [3, 3, 3, 0, 0, 0, 0, 3, 3, 3],
    [3, 3, 0, 0, 0, 0, 0, 0, 3, 3],
    [3, 0, 0, 0, 0, 0, 0, 0, 0, 3],
    [0, 0, 0, 0, 0, 3, 0, 0, 0, 0],
    [0, 0, 0, 0, 0, 3, 0, 0, 0, 0],
    [0, 0, 0, 0, 0, 3, 0, 0, 0, 0],
    [0, 0, 0, 0, 0, 3, 0, 0, 0, 0],
    [0, 0, 3, 3, 3, 3, 3, 3, 0, 0],
    [0, 0, 0, 0, 3, 0, 0, 0, 0, 0],
    [0, 0, 0, 0, 3, 0, 0, 0, 0, 0],
    [0, 0, 0, 0, 3, 0, 0, 0, 0, 0],
    [3, 0, 0, 0, 3, 0, 0, 0, 0, 3],
    [3, 3, 0, 0, 0, 0, 0, 0, 3, 3],
    [3, 3, 3, 0, 0, 0, 0, 3, 3, 3]
  ],

  "gold_level": false,

  "runes_weight":
  [
    {"rune": "fire", "weight": 20},
    {"rune": "lightning", "weight": 40},
    {"rune": "plant", "weight": 20},
    {"rune": "water", "weight": 20},
	{"rune": "earth", "weight": 0},
	{"rune": "psy", "weight": 0}
  ],

  "medallions":
  [
    {"score":  4000, "exp": 50},
    {"score":  4000, "exp": 150},
    {"score":  4000, "exp": 300}
  ]
}