{
  "name": "level_13",

  "time": 60,
  "gems": [ 40, 20 ],
  "layout":
  [

    [3, 3, 3, 0, 0, 0, 0, 3, 3, 3],
    [3, 3, 0, 0, 0, 0, 0, 0, 3, 3],
    [3, 0, 0, 0, 0, 0, 0, 0, 0, 3],
    [0, 0, 3, 3, 0, 5, 5, 0, 0, 0],
    [0, 0, 0, 0, 0, 0, 5, 0, 0, 0],
    [0, 0, 5, 0, 0, 0, 0, 0, 0, 0],
    [0, 0, 5, 0, 0, 0, 0, 0, 0, 0],
    [0, 0, 5, 0, 0, 0, 0, 0, 0, 0],
    [0, 0, 5, 0, 0, 0, 0, 0, 0, 0],
    [0, 0, 0, 0, 0, 0, 0, 0, 0, 0],
    [0, 0, 0, 0, 0, 5, 5, 0, 0, 0],
    [3, 0, 0, 0, 0, 0, 0, 0, 0, 3],
    [3, 3, 0, 0, 0, 0, 0, 0, 3, 3],
    [3, 3, 3, 0, 0, 0, 0, 3, 3, 3]
  ],

  "gold_level": false,

  "runes_weight":
  [
    {"rune": "fire", "weight": 25},
    {"rune": "lightning", "weight": 25},
    {"rune": "plant", "weight": 25},
    {"rune": "water", "weight": 25},
	{"rune": "earth", "weight": 0},
	{"rune": "psy", "weight": 0}
  ],

  "medallions":
  [
    {"score": 5000, "exp": 4000},
    {"score": 8000, "exp": 6000},
    {"score": 9500, "exp": 10000}
  ]
}