{
  "name": "level_18",

  "time": 60,
  "gems": [ 40, 20 ],
  "layout":
  [

    [3, 3, 3, 0, 0, 0, 0, 3, 3, 3],
    [3, 3, 0, 0, 0, 0, 0, 0, 3, 3],
    [3, 0, 0, 4, 0, 0, 3, 3, 3, 3],
    [0, 0, 0, 0, 0, 5, 0, 0, 3, 0],
    [5, 0, 0, 0, 0, 5, 0, 0, 3, 0],
    [5, 3, 3, 0, 0, 5, 0, 0, 3, 0],
    [5, 0, 0, 0, 0, 5, 0, 0, 3, 0],
    [5, 0, 0, 3, 0, 0, 0, 0, 0, 0],
    [0, 0, 0, 0, 0, 0, 0, 0, 0, 3],
    [0, 4, 0, 4, 0, 4, 0, 4, 0, 3],
    [0, 0, 0, 0, 0, 0, 0, 0, 0, 3],
    [3, 0, 0, 0, 0, 0, 0, 0, 0, 3],
    [3, 3, 0, 0, 0, 0, 0, 0, 3, 3],
    [3, 3, 3, 0, 0, 0, 0, 3, 3, 3]
  ],

  "gold_level": false,

  "runes_weight":
  [
    {"rune": "fire", "weight": 25},
    {"rune": "lightning", "weight": 25},
    {"rune": "plant", "weight": 25},
    {"rune": "water", "weight": 25},
	{"rune": "earth", "weight": 0},
	{"rune": "psy", "weight": 0}
  ],

  "medallions":
  [
    {"score": 3000, "exp": 5000},
    {"score": 5000, "exp": 10000},
    {"score": 6500, "exp": 12000}
  ]
}