{
  "name": "level_57",

  "time": 120,
  "gems": [ 90, 60, 30 ],
  "layout":
  [

    [3, 3, 3, 3, 3, 3, 3, 3, 3, 3],
    [3, 3, 3, 3, 3, 3, 3, 3, 3, 3],
    [3, 0, 3, 3, 3, 3, 3, 3, 3, 3],
    [0, 0, 0, 3, 3, 3, 3, 3, 3, 3],
    [0, 0, 0, 0, 3, 3, 3, 3, 3, 3],
    [2, 2, 2, 2, 2, 3, 3, 3, 3, 3],
    [2, 2, 2, 2, 2, 0, 3, 3, 3, 3],
    [2, 2, 2, 2, 2, 0, 0, 3, 3, 3],
    [2, 2, 2, 2, 2, 0, 0, 0, 3, 3],
    [2, 2, 2, 2, 2, 0, 0, 0, 0, 3],
    [2, 2, 2, 2, 2, 2, 2, 2, 2, 2],
    [3, 2, 2, 2, 2, 2, 2, 2, 2, 3],
    [3, 3, 2, 2, 2, 2, 2, 2, 3, 3],
    [3, 3, 3, 2, 2, 2, 2, 3, 3, 3]
  ],

  "gold_level": true,

  "runes_weight":
  [
    {"rune": "fire", "weight": 20},
    {"rune": "lightning", "weight": 20},
    {"rune": "plant", "weight": 20},
    {"rune": "water", "weight": 20},
	{"rune": "earth", "weight": 0},
	{"rune": "psy", "weight": 10}
  ],

  "medallions":
  [
     {"score":  15000, "exp": 50000},
     {"score":  19000, "exp": 100000},
     {"score":  21000, "exp": 250000}
  ]
}