{
  "name": "level_54",

  "time": 120,
  "gems": [ 90, 60, 30 ],
  "layout":
  [

    [3, 3, 3, 0, 3, 0, 0, 3, 3, 3],
    [3, 3, 0, 0, 3, 0, 0, 0, 3, 3],
    [3, 0, 0, 0, 3, 0, 0, 0, 0, 3],
    [0, 0, 0, 0, 0, 0, 0, 0, 0, 0],
    [0, 0, 0, 6, 0, 6, 0, 0, 0, 0],
    [0, 0, 0, 6, 0, 6, 0, 0, 0, 0],
    [3, 3, 3, 3, 3, 3, 3, 3, 3, 3],
    [0, 0, 0, 6, 3, 6, 0, 0, 0, 0],
    [0, 0, 0, 6, 3, 6, 0, 0, 0, 0],
    [0, 0, 0, 3, 3, 3, 0, 0, 0, 0],
    [0, 0, 0, 0, 3, 0, 0, 0, 0, 0],
    [3, 0, 0, 0, 3, 0, 0, 0, 0, 3],
    [3, 3, 0, 0, 3, 0, 0, 0, 3, 3],
    [3, 3, 3, 0, 3, 0, 0, 3, 3, 3]
  ],

  "gold_level": false,

  "runes_weight":
  [
    {"rune": "fire", "weight": 20},
    {"rune": "lightning", "weight": 20},
    {"rune": "plant", "weight": 20},
    {"rune": "water", "weight": 20},
	{"rune": "earth", "weight": 10},
	{"rune": "psy", "weight": 0}
  ],

  "medallions":
  [
    {"score":  5000, "exp": 35000},
    {"score":  8000, "exp": 50000},
    {"score":  9000, "exp": 100000}
  ]
}