{
  "name": "level_48",

  "time": 105,
  "gems": [ 70, 30 ],
  "layout":
  [

    [3, 3, 3, 0, 0, 0, 0, 3, 3, 3],
    [3, 3, 0, 0, 0, 0, 0, 0, 3, 3],
    [3, 0, 0, 3, 3, 3, 3, 0, 0, 3],
    [0, 0, 0, 1, 1, 1, 1, 0, 0, 0],
    [0, 0, 0, 2, 2, 2, 2, 0, 0, 0],
    [0, 2, 2, 2, 2, 2, 2, 2, 2, 0],
    [1, 1, 1, 1, 1, 1, 1, 1, 1, 1],
    [1, 1, 1, 1, 1, 1, 1, 1, 1, 1],
    [0, 0, 0, 4, 4, 4, 4, 0, 0, 0],
    [0, 4, 4, 0, 0, 0, 0, 4, 4, 0],
    [0, 0, 0, 0, 0, 0, 0, 0, 0, 0],
    [3, 0, 0, 0, 0, 0, 0, 0, 0, 3],
    [3, 3, 0, 0, 0, 0, 0, 0, 3, 3],
    [3, 3, 3, 0, 0, 0, 0, 3, 3, 3]
  ],

  "gold_level": true,

  "runes_weight":
  [
    {"rune": "fire", "weight": 0},
    {"rune": "lightning", "weight": 20},
    {"rune": "plant", "weight": 20},
    {"rune": "water", "weight": 20},
	{"rune": "earth", "weight": 10},
	{"rune": "psy", "weight": 10}
  ],

  "medallions":
  [
    {"score":  14000, "exp": 35000},
    {"score":  17000, "exp": 50000},
    {"score":  20000, "exp": 100000}
  ]
}