{
  "name": "level_50",

  "time": 105,
  "gems": [ 70, 30 ],
  "layout":
  [

    [3, 3, 3, 0, 2, 2, 0, 3, 3, 3],
    [3, 3, 0, 0, 2, 2, 0, 0, 3, 3],
    [3, 0, 0, 0, 2, 2, 0, 0, 0, 3],
    [0, 0, 0, 0, 2, 2, 1, 1, 1, 1],
    [1, 1, 1, 1, 2, 2, 0, 0, 0, 0],
    [0, 0, 0, 0, 2, 2, 1, 1, 1, 1],
    [1, 1, 1, 1, 2, 2, 0, 0, 0, 0],
    [0, 0, 0, 0, 2, 2, 1, 1, 1, 1],
    [1, 1, 1, 1, 2, 2, 0, 0, 0, 0],
    [0, 0, 0, 0, 2, 2, 1, 1, 1, 1],
    [1, 1, 1, 1, 2, 2, 0, 0, 0, 0],
    [3, 0, 0, 0, 2, 2, 0, 0, 0, 3],
    [3, 3, 0, 0, 2, 2, 0, 0, 3, 3],
    [3, 3, 3, 0, 2, 2, 0, 3, 3, 3]
  ],

  "gold_level": true,

  "runes_weight":
  [
    {"rune": "fire", "weight": 20},
    {"rune": "lightning", "weight": 0},
    {"rune": "plant", "weight": 20},
    {"rune": "water", "weight": 20},
	{"rune": "earth", "weight": 0},
	{"rune": "psy", "weight": 10}
  ],

  "medallions":
  [
     {"score":  25000, "exp": 35000},
     {"score":  26000, "exp": 50000},
     {"score":  27500, "exp": 100000}
  ]
}