{
  "name": "level_28",

  "time": 75,
  "gems": [ 50, 30 ],
  "layout":
  [

    [3, 3, 3, 0, 0, 0, 0, 3, 3, 3],
    [3, 3, 0, 0, 0, 0, 0, 0, 3, 3],
    [3, 0, 4, 0, 0, 3, 0, 0, 0, 3],
    [0, 0, 0, 4, 0, 3, 0, 3, 0, 0],
    [0, 0, 0, 4, 0, 0, 0, 0, 0, 0],
    [0, 0, 0, 4, 0, 0, 6, 6, 0, 6],
    [0, 0, 0, 4, 0, 0, 6, 6, 0, 6],
    [0, 0, 0, 0, 0, 0, 0, 0, 0, 6],
    [0, 0, 0, 0, 0, 0, 0, 0, 0, 0],
    [0, 0, 3, 3, 3, 0, 0, 0, 0, 0],
    [0, 0, 0, 0, 0, 0, 0, 0, 0, 0],
    [3, 0, 0, 0, 0, 0, 3, 0, 0, 3],
    [3, 3, 0, 0, 0, 0, 0, 0, 3, 3],
    [3, 3, 3, 0, 0, 0, 0, 3, 3, 3]
  ],

  "gold_level": false,

  "runes_weight":
  [
    {"rune": "fire", "weight": 20},
    {"rune": "lightning", "weight": 20},
    {"rune": "plant", "weight": 20},
    {"rune": "water", "weight": 20},
	{"rune": "earth", "weight": 10},
	{"rune": "psy", "weight": 0}
  ],

  "medallions":
  [
    {"score": 4000, "exp": 15000},
    {"score": 6000, "exp": 20000},
    {"score": 8000, "exp": 25000}
  ]
}