{
  "name": "level_58",

  "time": 120,
  "gems": [ 90, 60, 30 ],
  "layout":
  [

    [3, 3, 3, 3, 3, 0, 0, 3, 3, 3],
    [3, 3, 0, 0, 3, 0, 0, 0, 3, 3],
    [3, 0, 0, 0, 3, 0, 0, 0, 0, 3],
    [0, 0, 0, 0, 3, 0, 0, 0, 0, 0],
    [0, 0, 0, 0, 3, 0, 0, 0, 0, 0],
    [3, 3, 3, 3, 3, 0, 0, 0, 0, 0],
    [3, 3, 3, 3, 3, 3, 3, 3, 3, 3],
    [3, 3, 3, 3, 3, 0, 0, 0, 0, 0],
    [0, 0, 0, 0, 3, 0, 0, 0, 0, 0],
    [0, 0, 0, 0, 3, 0, 0, 0, 0, 0],
    [0, 0, 0, 0, 3, 0, 0, 0, 0, 0],
    [3, 0, 0, 0, 3, 0, 0, 0, 0, 3],
    [3, 3, 0, 0, 3, 0, 0, 0, 3, 3],
    [3, 3, 3, 3, 3, 0, 0, 3, 3, 3]
  ],

  "gold_level": false,

  "runes_weight":
  [
    {"rune": "fire", "weight": 20},
    {"rune": "lightning", "weight": 20},
    {"rune": "plant", "weight": 20},
    {"rune": "water", "weight": 20},
	{"rune": "earth", "weight": 10},
	{"rune": "psy", "weight": 0}
  ],

  "medallions":
  [
     {"score":  6000, "exp": 50000},
     {"score":  10000, "exp": 100000},
     {"score":  15000, "exp": 250000}
  ]
}