{
  "name": "level_34",

  "time": 90,
  "gems": [ 60, 30 ],
  "layout":
  [

    [3, 3, 3, 0, 0, 0, 0, 3, 3, 3],
    [3, 3, 0, 0, 0, 0, 0, 0, 3, 3],
    [3, 0, 0, 0, 0, 0, 0, 0, 0, 3],
    [0, 0, 3, 3, 3, 3, 3, 3, 0, 0],
    [0, 0, 3, 0, 0, 0, 0, 0, 0, 0],
    [0, 0, 3, 0, 0, 0, 0, 0, 0, 0],
    [0, 0, 3, 0, 0, 3, 3, 3, 0, 0],
    [0, 0, 3, 0, 0, 0, 0, 3, 0, 0],
    [0, 0, 3, 0, 0, 0, 0, 3, 0, 0],
    [0, 0, 3, 0, 0, 0, 0, 3, 0, 0],
    [0, 0, 3, 3, 3, 3, 3, 3, 0, 0],
    [3, 0, 0, 0, 0, 0, 0, 0, 0, 3],
    [3, 3, 0, 0, 0, 0, 0, 0, 3, 3],
    [3, 3, 3, 0, 0, 0, 0, 3, 3, 3]
  ],

  "gold_level": false,

  "runes_weight":
  [
    {"rune": "fire", "weight": 20},
    {"rune": "lightning", "weight": 20},
    {"rune": "plant", "weight": 40},
    {"rune": "water", "weight": 20},
	{"rune": "earth", "weight": 0},
	{"rune": "psy", "weight": 10}
  ],

  "medallions":
  [
    {"score": 5000, "exp": 25000},
    {"score": 8000, "exp": 30000},
    {"score": 9000, "exp": 35000}
  ]
}