{
  "name": "level_12",

  "time": 60,
  "gems": [ 40, 20 ],
  "layout":
  [

    [3, 3, 3, 3, 3, 0, 0, 3, 3, 3],
    [3, 3, 0, 0, 3, 0, 0, 0, 3, 3],
    [3, 0, 0, 0, 3, 0, 0, 0, 0, 3],
    [0, 0, 0, 0, 3, 0, 0, 0, 0, 0],
    [0, 0, 0, 0, 3, 0, 0, 0, 0, 0],
    [0, 0, 0, 0, 3, 0, 0, 0, 0, 0],
    [0, 0, 0, 0, 3, 0, 0, 0, 0, 0],
    [0, 0, 0, 0, 3, 0, 0, 0, 0, 0],
    [0, 0, 0, 0, 3, 3, 3, 3, 3, 3],
    [0, 0, 0, 0, 0, 0, 0, 0, 0, 0],
    [0, 0, 0, 0, 0, 0, 0, 0, 0, 0],
    [3, 0, 0, 0, 0, 0, 0, 0, 0, 3],
    [3, 3, 0, 0, 0, 0, 0, 0, 3, 3],
    [3, 3, 3, 0, 0, 0, 0, 3, 3, 3]
  ],

  "gold_level": false,

  "runes_weight":
  [
    {"rune": "fire", "weight": 25},
    {"rune": "lightning", "weight": 25},
    {"rune": "plant", "weight": 25},
    {"rune": "water", "weight": 25},
	{"rune": "earth", "weight": 2},
	{"rune": "psy", "weight": 2}
  ],

  "medallions":
  [
    {"score": 4000,"exp": 5000},
    {"score": 5000, "exp": 6000},
    {"score": 6500, "exp": 10000}
  ]
}