{
  "name": "level_35",

  "time": 90,
  "gems": [ 60, 30 ],
  "layout":
  [

    [3, 3, 3, 0, 0, 0, 0, 3, 3, 3],
    [3, 3, 0, 0, 0, 0, 0, 0, 3, 3],
    [3, 0, 0, 0, 0, 0, 2, 2, 2, 3],
    [0, 0, 0, 0, 0, 0, 2, 2, 2, 0],
    [0, 0, 0, 0, 0, 0, 2, 2, 2, 0],
    [0, 2, 2, 2, 0, 0, 2, 2, 2, 0],
    [0, 2, 2, 2, 0, 0, 2, 2, 2, 0],
    [0, 2, 2, 2, 0, 0, 4, 4, 4, 0],
    [0, 2, 2, 2, 0, 0, 0, 0, 0, 0],
    [0, 2, 2, 2, 0, 0, 0, 0, 0, 0],
    [0, 4, 4, 4, 0, 0, 3, 3, 3, 3],
    [3, 0, 0, 0, 0, 0, 0, 0, 0, 3],
    [3, 3, 0, 0, 0, 0, 0, 0, 3, 3],
    [3, 3, 3, 0, 0, 0, 0, 3, 3, 3]
  ],

  "gold_level": true,

  "runes_weight":
  [
    {"rune": "fire", "weight": 20},
    {"rune": "lightning", "weight": 20},
    {"rune": "plant", "weight": 20},
    {"rune": "water", "weight": 20},
	{"rune": "earth", "weight": 0},
	{"rune": "psy", "weight": 10}
  ],

  "medallions":
  [
    {"score": 9000, "exp": 25000},
    {"score": 12000, "exp": 30000},
    {"score": 14000, "exp": 35000}
  ]
}